7 7
1 1 0 0 0 1 1 
1 1 1 1 1 1 1 
0 1 1 1 1 1 0 
0 1 1 0 1 1 0 
0 1 1 1 1 1 0 
1 1 1 1 1 1 1 
1 1 0 0 0 1 1 
BLUE 0 6
RED 0 0
PUPLE 6 0
GREEN 6 6
